111111111111111111111111111111
100001110011C000011E1C00010001
100110000000000001011101101011
100000011101010000000000000101
100100000010001101100011001111
111000010000001011000110111001
101100000010000011111001000101
100100101000111001000000001111
111001000111100100001010100101
101000010000101001100001010111
111100100011010000010010000111
1P0000010000001001001011101101
110101110000010010100010010101
100001011111011010000000010101
110000111010000110001000000001
100000001110110001000000110001
100011001001001100111000000011
100000100000000000110100011001
101011101100010001100000110001
100011100000101100101001010001
110001100011010011100010110111
100101010110001011111011011101
100000001110010000110000101101
110000000000000011000110010111
100000011000001000011001100101
100010001000000011001001011011
110100000110011010000100100111
101110001101110011010001001101
101010000111001011000011011001
111010011011001010000010000011
110001000010101000010101000001
110001010011100000010000000011
100001000100110010000110100101
111000001111111000101011101101
101011010001010111101100110101
111000000101100011100010100001
100010101001100110111100000011
101011000011001101111000100011
101000101000101111101110101111
111111111111111111111111111111
